30 30
11wwwwwwwwww111wwwwwwwwwwwww11
100000000000010000000000000001
100000000000010c00000000000c01
100000000000010000000000t00001
100000l00000010000000000000001
100000000000010000000l00000001
100000000000010000000000000001
1000000000c0010000000000000001
100000000000010000000000000001
111111001111111111110011111111
100000000000000100000000000001
10000000000000010000000000c001
100000000000000100000000000001
1000000l0000000100000000000001
1000000000000001000000l0000001
100c00000000000100000000000001
100000000000000100000000000001
111111111001111100000000000001
100000000000000111111111100111
100000000000000100000000000001
10c000000000000100000000000001
100000000000000100000000000001
10000000l000000100000000000001
1000000000000001000000l0000001
1000c0000000000000000000000001
100000000000000000000000000001
10000000000t000100000000000c01
100000000000000100000000000001
111wwwwwwwwww1111wwwwwwwwwww11
