29 30
11wwwwwwwwwww1111wwwwwwwwwww11
100000000000001000000000000001
1000000000000010c0000t00000c01
100000000000001000000000000001
1000l00000l0001000l000000l0001
100000000000001000000000000001
100000000000001000000000000001
100000000000c010c0000000000001
100000000000001000000000000001
111111110011111111111111110011
100000000000100000000000000001
10c00000000010c0000000000l0c01
100000000000100000000100000001
100l00000l00100l00111111111111
10000000000010t000000000000001
10000000000010000000l00000l001
100000000000100000100000000001
110011111111111111111110011111
100001000000000001000000000001
10l0010c0000000c01000000000c01
1000010000000000010000000l0001
10000100l000000001000000000001
100001000000000001000000000001
100001000000000000000000000t01
10l0010000000l0000000000000001
10000000000000000100l000000001
10t000000000000001000000000001
100001000000000001000000000001
11111111wwwwwww1111wwwwwwwww11
